WW0WWWW000WW0WW
W00WWWW0WW0000W
WW0000W0000WW0W
WWWWW0WWWW0WW0E
00W000000W0W0WW
W0W0WWWW0W00000
W0W0WW0W0W00W0W
W0W00W0W0W00W00
000W0W0W0WW0WWW
0W0W000W00W0WW0
0W0W0W0WW0000W0
0WWW0W000WWW0W0
S0000W0W000W000
WWW0WW00WW0WW0W
W000000WWWWWWWW