WW.WWWW...WW.WW
W..WWWW.WW....W
WW....W....WW.W
WWWWW.WWWW.WW.B
..W......W.W.WW
W.W.WWWW.W.....
W.W.WW.W.W.WW.W
W.W..W.W.W..W..
...W.W.W.WW.WWW
.W.W...W..W.WW.
.W.W.W.WW....W.
.WWW.W...WWW.W.
M....W.W...W...
WWW.WW..WW.WW.W
W......WWWWWWWW